"","country","equipment_type","destroyed","abandoned","captured","damaged","type_total","row_id","Date"
"1","Russia","All Types",2458,316,1365,72,4211,1,"2022-06-02"
"2","Russia","Tanks",419,55,255,20,749,2,"2022-06-02"
"3","Russia","Armoured Fighting Vehicles",239,36,135,3,413,3,"2022-06-02"
"4","Russia","Infantry Fighting Vehicles",508,64,241,12,825,4,"2022-06-02"
"5","Russia","Armoured Personnel Carriers",41,14,55,2,112,5,"2022-06-02"
"6","Russia","Mine-Resistant Ambush Protected",14,3,8,1,26,6,"2022-06-02"
"7","Russia","Infantry Mobility Vehicles",70,5,33,2,110,7,"2022-06-02"
"8","Russia","Command Posts And Communications Stations",37,8,34,0,79,8,"2022-06-02"
"9","Russia","Engineering Vehicles And Equipment",50,40,69,0,159,9,"2022-06-02"
"10","Russia","Self-Propelled Anti-Tank Missile Systems",7,3,7,0,17,10,"2022-06-02"
"11","Russia","Heavy Mortars",5,0,8,0,13,11,"2022-06-02"
"12","Russia","Towed Artillery",13,5,39,4,61,12,"2022-06-02"
"13","Russia","Self-Propelled Artillery",54,16,48,2,120,13,"2022-06-02"
"14","Russia","Multiple Rocket Launchers",33,3,32,1,69,14,"2022-06-02"
"15","Russia","Anti-Aircraft Guns",2,0,5,0,7,15,"2022-06-02"
"16","Russia","Self-Propelled Anti-Aircraft Guns",7,2,6,0,15,16,"2022-06-02"
"17","Russia","Surface-To-Air Missile Systems",34,7,21,1,63,17,"2022-06-02"
"18","Russia","Radars",4,0,6,0,10,18,"2022-06-02"
"19","Russia","Jammers And Deception Systems",5,0,2,2,9,19,"2022-06-02"
"20","Russia","Aircraft",30,0,0,0,30,20,"2022-06-02"
"21","Russia","Helicopters",40,1,1,1,43,21,"2022-06-02"
"22","Russia","Unmanned Aerial Vehicles",43,0,37,0,80,22,"2022-06-02"
"23","Russia","Naval Ships",7,0,0,2,9,23,"2022-06-02"
"24","Russia","Logistics Trains",2,0,0,0,2,24,"2022-06-02"
"25","Russia","Trucks, Vehicles and Jeeps",802,67,296,22,1187,25,"2022-06-02"
"26","Ukraine","All Types",535,35,528,24,1122,1,"2022-06-02"
"27","Ukraine","Tanks",83,8,93,3,187,2,"2022-06-02"
"28","Ukraine","Armoured Fighting Vehicles",31,4,50,0,85,3,"2022-06-02"
"29","Ukraine","Infantry Fighting Vehicles",68,9,50,3,130,4,"2022-06-02"
"30","Ukraine","Armoured Personnel Carriers",21,3,40,1,65,5,"2022-06-02"
"31","Ukraine","Infantry Mobility Vehicles",34,1,65,1,101,6,"2022-06-02"
"32","Ukraine","Infantry Mobility Vehicles",1,0,1,0,2,7,"2022-06-02"
"33","Ukraine","Command Posts And Communications Stations",0,0,2,0,2,8,"2022-06-02"
"34","Ukraine","Engineering Vehicles",3,0,10,0,13,9,"2022-06-02"
"35","Ukraine","Self-Propelled Anti-Tank Missile Systems",5,0,6,0,11,10,"2022-06-02"
"36","Ukraine","Towed Artillery",9,3,16,3,31,11,"2022-06-02"
"37","Ukraine","Self-Propelled Artillery",16,1,16,5,38,12,"2022-06-02"
"38","Ukraine","Multiple Rocket Launchers",14,0,5,0,19,13,"2022-06-02"
"39","Ukraine","Anti-Aircraft Guns",0,0,3,0,3,14,"2022-06-02"
"40","Ukraine","Self-Propelled Anti-Aircraft Guns
",0,0,2,0,2,15,"2022-06-02"
"41","Ukraine","Surface-To-Air Missile Systems
",37,1,6,0,44,16,"2022-06-02"
"42","Ukraine","Radars And Communications Equipment",11,1,8,3,23,17,"2022-06-02"
"43","Ukraine","Aircraft",25,0,0,0,25,18,"2022-06-02"
"44","Ukraine","Helicopters",8,0,3,0,11,19,"2022-06-02"
"45","Ukraine","Unmanned Aerial Vehicles",14,0,5,0,19,20,"2022-06-02"
"46","Ukraine","Naval Ships",5,0,13,0,18,21,"2022-06-02"
"47","Ukraine","Trucks, Vehicles and Jeeps",138,5,147,5,295,22,"2022-06-02"
